20 22 22 20 20 0 20 0 0 0 0 0 0 0 0 0 0 0 0 0 0 0 0 0 0 0 0 0 0 0
20 20 20 20 22 12 0 0 0 0 0 0 0 0 0 0 0 0 0 0 0 0 0 0 0 10 0 0 23 10
20 22 0 0 0 0 20 20 0 0 0 0 0 0 0 0 0 0 0 0 0 6 0 0 0 0 23 0 0 21
12 0 0 18 0 20 22 12 0 0 6 0 0 0 11 12 11 0 0 0 0 0 0 0 0 0 0 0 0 21
0 20 20 0 0 20 20 0 0 0 0 0 0 0 0 0 0 0 0 0 0 0 0 0 23 0 23 0 0 0
12 0 20 0 0 22 20 0 0 0 0 0 0 0 0 0 0 0 0 0 0 0 0 0 10 23 21 21 0 0
22 20 20 0 0 20 0 0 3 3 0 0 0 0 0 0 0 0 6 0 0 0 0 0 0 10 21 0 23 0
0 20 0 20 0 0 0 0 0 2 0 0 0 0 11 0 0 0 0 0 0 0 0 0 0 0 0 0 0 10
0 0 20 20 0 0 0 0 0 2 0 0 0 0 0 12 0 0 0 0 0 0 0 0 0 0 0 0 0 0
0 0 0 0 0 0 0 0 0 0 0 0 9 0 0 11 11 0 0 16 3 0 0 19 0 0 0 0 0 0
0 0 0 0 0 0 0 0 0 0 0 0 0 0 0 0 0 0 0 0 0 0 0 0 0 0 0 0 0 0
0 0 0 0 0 0 0 0 0 0 0 0 0 0 0 0 0 0 0 0 0 0 0 0 12 10 0 0 0 0
0 0 0 0 0 0 0 0 0 0 0 0 0 0 0 0 0 0 0 0 0 0 0 0 0 0 0 0 0 0
6 6 0 0 0 0 0 15 0 0 0 9 0 0 0 0 16 3 0 0 0 0 0 0 0 0 0 0 0 0
0 0 0 0 0 0 0 0 0 0 0 0 0 0 0 0 0 0 16 0 0 0 0 0 0 0 0 0 0 0
0 0 0 0 0 0 0 0 0 0 0 0 0 0 0 0 0 0 0 0 0 0 0 0 0 0 0 0 0 12
11 10 0 0 0 0 0 0 0 0 0 0 0 0 0 0 0 0 0 0 0 0 0 0 0 0 12 0 0 10
11 10 0 0 0 0 0 0 0 0 8 7 0 7 0 8 7 0 7 0 0 0 0 0 0 0 0 0 0 0
0 0 0 0 0 0 0 0 0 0 0 0 0 0 0 0 0 0 0 0 0 0 0 0 0 9 0 0 0 0
0 0 0 0 0 0 0 0 0 0 0 0 0 0 0 0 0 0 0 0 0 0 0 0 0 0 0 0 0 0
0 0 0 0 0 0 0 0 0 0 9 0 0 0 0 0 0 0 0 0 0 0 0 0 0 0 0 0 0 0
0 0 0 0 0 0 0 0 0 0 0 0 0 0 0 0 0 1 1 0 0 0 0 0 0 0 0 0 4 2
0 0 0 0 0 0 0 0 0 0 0 0 0 0 0 0 0 0 0 0 0 0 0 0 0 0 0 0 0 0
0 4 1 0 0 0 0 9 0 0 0 0 0 0 0 0 0 0 0 0 0 0 16 0 0 0 0 0 0 0
0 0 1 0 0 0 0 0 0 0 0 0 0 0 0 0 0 0 0 23 0 0 0 23 0 0 0 5 0 0
0 0 0 0 0 0 0 0 0 4 0 0 0 0 0 0 0 0 23 0 0 17 0 0 0 0 0 0 0 0
0 0 0 0 0 0 0 0 0 0 0 0 0 0 0 0 0 0 23 0 0 0 0 0 0 0 0 0 0 11
0 0 0 9 0 0 0 0 0 0 0 0 0 0 0 0 0 0 0 23 0 23 0 23 0 0 0 5 0 11
0 0 0 0 0 0 0 0 16 0 0 0 0 0 0 5 0 0 0 23 0 23 0 0 24 0 0 11 0 0
19 0 0 0 0 0 19 0 0 0 0 0 0 0 0 0 0 0 0 4 0 0 0 23 0 23 0 0 5 0