8 0 0 0 0 0 0 0 0 0 21 0 0 0 0 0 0 0 0 0 0 0 0 0 0 0 6 0 0 6
0 0 0 0 0 3 4 0 0 0 0 0 0 8 0 0 0 0 0 0 0 0 0 20 0 0 0 0 0 0
0 0 0 0 0 0 0 0 0 0 13 22 13 0 0 0 0 20 0 0 0 0 0 0 0 0 0 0 0 0
4 3 0 0 0 0 0 0 0 0 22 22 22 0 0 0 0 0 0 0 0 0 0 0 0 0 1 0 0 1
0 0 0 0 0 0 0 0 0 0 0 0 0 0 0 0 0 0 0 0 0 0 0 0 0 1 0 0 0 0
0 0 0 0 0 0 1 2 22 0 0 2 0 0 0 0 22 0 0 0 0 2 22 0 0 0 0 0 0 0
0 0 20 0 0 0 0 0 0 4 0 0 0 0 0 0 0 0 0 0 0 0 0 0 0 0 0 0 0 0
0 0 19 0 0 0 0 0 0 0 0 0 0 0 0 0 0 0 0 0 0 0 0 0 0 0 4 0 0 0
0 0 20 0 0 0 0 0 0 0 0 0 0 0 2 2 0 0 0 0 0 0 0 0 0 0 0 0 0 0
0 0 19 0 0 0 0 0 0 0 0 0 0 10 10 18 0 0 0 0 0 0 6 0 0 0 0 0 0 0
0 0 0 0 0 0 0 0 0 0 0 0 0 0 0 0 0 0 0 0 0 0 0 0 0 0 0 0 0 0
0 0 0 0 0 0 0 0 0 8 0 11 0 0 0 0 0 0 0 0 0 0 0 0 0 0 0 0 0 0
13 0 0 0 0 0 0 0 0 0 0 0 0 0 0 0 0 0 0 0 0 0 0 0 0 0 4 3 0 0
0 0 0 0 0 0 0 0 0 0 0 0 0 0 0 8 0 11 0 4 0 0 0 0 0 0 0 0 0 0
0 0 0 0 0 0 0 0 0 0 0 0 0 0 0 0 0 0 0 0 0 0 0 0 0 0 21 0 0 4
6 0 0 0 0 0 0 10 18 10 0 0 0 0 0 0 0 0 0 0 2 0 0 0 0 0 0 0 0 3
0 0 0 4 0 0 0 0 0 0 0 0 0 0 0 0 0 0 0 0 0 0 0 0 0 0 0 0 0 0
0 0 0 0 0 0 0 0 0 0 0 0 0 0 0 0 0 0 0 0 0 0 0 0 0 0 0 0 0 8
0 0 0 0 0 0 0 0 0 0 0 0 4 0 0 0 0 0 0 0 0 0 0 3 0 0 0 0 0 0
0 0 2 0 0 0 0 0 0 0 0 0 0 0 0 0 0 0 22 22 0 0 0 0 0 0 0 0 0 0
0 0 0 0 0 0 0 0 0 0 0 0 0 0 0 0 0 0 0 0 0 0 0 0 0 0 0 0 0 0
21 0 0 0 0 0 0 0 0 0 1 0 0 0 0 0 0 0 0 0 0 0 0 0 0 0 0 0 20 0
0 0 0 0 0 0 0 0 0 0 0 0 0 0 22 0 0 0 0 0 0 0 0 20 0 7 20 0 0 0
0 0 0 0 22 0 0 2 0 0 0 0 0 0 0 0 0 3 0 0 0 0 20 7 0 0 9 20 0 0
0 0 8 0 11 0 0 0 0 0 0 5 0 0 0 0 0 4 0 0 0 20 7 20 0 0 7 0 0 0
22 0 0 0 0 0 0 0 0 0 5 0 0 0 0 0 0 0 0 0 0 0 0 0 9 7 0 15 20 0
0 0 0 22 22 0 0 0 0 0 0 14 5 0 0 0 0 0 0 0 0 0 20 0 15 0 0 0 20 0
0 0 8 22 11 0 0 0 0 0 5 0 0 0 0 0 0 0 0 0 0 0 0 20 0 7 0 20 0 15
0 0 0 0 0 0 0 4 3 0 0 0 0 0 0 3 0 0 0 20 0 20 0 20 0 0 20 0 0 0
21 0 0 0 0 0 0 0 0 0 0 14 0 0 0 4 0 0 0 0 0 0 0 0 0 20 0 0 20 0