44,44,44,44,44,44,44,44,44,44,44,44,44,44,44,44,44,44,44,44,44,44,44,44,44,44,44,44,44,44,
44,44,44,44,44,44,44,44,44,44,44,44,44,44,44,44,44,44,44,44,44,44,44,44,44,44,44,44,44,44,
44,44,44,44,44,44,44,44,44,44,44,44,44,44,44,44,44,44,44,44,44,44,44,44,44,44,44,44,44,44,
44,44,44,44,44,44,44,44,44,44,44,44,44,44,44,44,44,44,44,44,44,44,44,44,44,44,44,44,44,44,
44,44,44,44,44,44,44,44,44,44,44,44,44,44,44,44,44,44,44,44,44,44,44,44,44,44,44,44,44,44,
44,44,44,44,44,44,44,44,44,44,44,44,44,44,44,44,44,44,44,44,44,44,44,44,44,44,44,44,44,44,
44,44,44,44,44,44,44,44,44,44,44,44,44,44,44,44,44,44,44,44,44,44,44,44,44,44,44,44,44,44,
44,44,44,44,44,44,4,20,6,44,44,44,44,44,44,44,44,44,44,44,44,44,44,44,44,44,44,44,44,44,
44,44,44,44,44,44,12,14,10,44,44,44,44,44,44,44,44,44,44,44,44,44,44,44,44,44,44,44,44,44,
44,44,44,44,44,44,12,14,19,20,20,20,6,44,44,44,44,44,44,44,44,44,44,44,44,44,44,44,44,44,
44,44,44,44,44,44,12,14,14,14,14,14,10,44,44,44,44,44,44,44,44,44,44,44,44,44,44,44,44,44,
44,44,44,44,44,44,12,14,1,2,2,2,24,44,44,44,44,44,44,44,44,44,44,44,44,44,44,44,44,44,
44,44,44,44,44,44,12,14,10,44,44,44,44,44,44,44,44,44,44,44,44,44,44,44,44,44,44,44,44,44,
44,44,44,44,44,44,12,14,10,44,44,44,44,44,44,44,44,44,44,44,44,44,44,44,44,44,44,44,44,44,
44,44,44,44,44,44,12,14,10,44,44,44,44,44,44,44,44,44,44,44,44,44,44,44,44,44,44,44,44,44,
44,44,44,44,44,44,12,14,10,44,44,44,44,44,44,44,44,44,44,44,44,44,44,44,44,44,44,44,44,44,
44,44,44,44,44,44,12,14,10,44,44,44,44,44,44,44,44,44,44,44,44,44,44,44,44,44,44,44,44,44,
44,44,44,44,44,44,12,14,10,44,44,44,44,44,44,44,44,44,44,44,44,44,44,44,44,44,44,44,44,44,
20,20,20,20,20,20,21,14,19,20,20,20,20,20,20,20,20,20,20,20,20,20,20,20,20,20,20,20,20,20,
14,14,14,14,14,14,14,14,14,14,14,14,14,14,14,14,14,14,14,14,14,14,14,14,14,14,14,14,14,14,
2,2,2,3,14,1,2,2,2,2,2,2,3,14,1,2,2,2,2,2,2,2,2,2,2,2,2,2,2,2,
44,44,44,12,14,10,44,44,44,44,44,44,12,14,10,44,44,44,44,44,44,44,44,44,44,44,44,44,44,44,
44,44,44,12,14,10,44,44,44,44,44,44,12,14,10,44,44,44,44,44,44,44,44,44,44,44,44,44,44,44,
44,44,44,12,14,10,44,44,44,44,44,44,12,14,10,44,44,44,44,44,44,44,44,44,44,44,44,44,44,44,
44,44,44,12,14,10,44,44,44,44,44,44,12,14,10,44,44,44,44,44,44,44,44,44,44,44,44,44,44,44,
44,44,44,12,14,10,44,44,44,44,44,44,12,14,10,44,44,44,44,44,44,44,44,44,44,44,44,44,44,44,
44,44,44,12,14,10,44,44,44,44,44,44,22,2,24,44,44,44,44,44,44,44,44,44,44,44,44,44,44,44,
44,44,44,12,14,10,44,44,44,44,44,44,44,44,44,44,44,44,44,44,44,44,44,44,44,44,44,44,44,44,
44,44,44,12,14,10,44,44,44,44,44,44,44,44,44,44,44,44,44,44,44,44,44,44,44,44,44,44,44,44,
44,44,44,22,2,24,44,44,44,44,44,44,44,44,44,44,44,44,44,44,44,44,44,44,44,44,44,44,44,44
44,44,44,44,44,44,44,44,44,44,44,44,44,44,44,44,44,44,44,44,44,44,44,44,44,44,44,44,44,44